WWWWWWWWWWWWWWWWWBBBBBBBBBBBBBVVVVVVVV
WWWWWWWWWGGBGBGGWWGGGGGGGGGGGGVFFFFFFV
WWWWWWWWWWWWKGGGGWWWGGGGGGGGGGVFFFFFFV
WWWWWWWWWWGGGGGGBGWWWGGGGGGGGGVFFPFFFV
WWWWWWGGGGGGGGGGGGGWWGGGGGGGGGVFFFFFFV
WWWGGGGGGGGGBBBBGGGGWAWGGGGGGGVFFFFFFV
BGGGGGBGGBBGGGBBBBGGGGWGGGGGGGVVVVDVVV
BGGBGGGBBBBBBBBBBGGEGGWWWWGGGGGGGGGGGB
BGGGGBBBBBBBBBBGGBGGGGGGGWWWWWGGGGGGGB
BGBGGGGBBBBBBBGGEGGBGGGGGGGBBWWWWWAWWW
BGEGGGGGBBBBSSGGBBBGGGBGGGBBBBBBBBGGGB
BGBGGGBGGGGGGSSSSSSGGGGGBBBBBBBBBBBBGB
BGGGGGGGGGGGGGBBBBSSSSSSSSBBBBBBBGGGGB
WWWWWWAWWWWWGGGGGGGGGGGGBBBBGGBBBBGGBB
BGGGGGGGGGGWWWWWWWWWWGGGGGGGGGGGGGGGGB
BGGSSSSCSGGGGGGBGGGGWWWWWWWWWWWGGGGGGB
BGGGSSCSSCSSSSGGGEGBGGGGGGGGGGWWWAWWWW
BGSSSCSSSSSSCSSSCSSGGGGGGGWWWWWGGGBGBB
BSBSSSCSSSCSSSCSSCSSSGGGWWWGGGGGGGGGGB
BGGGGSSCSSSCSSSCSSGGWWWWWGGGBGBGBGBGBB
WWWWWWWWWAWWWWWWWWWWWGBBBBBBBBGEGGGBBB
BLGGGGGGGGGGGGGGGGGGGGGGGGGGGGGGGGGBBB
BBBBBBBBBBBBBBBBBBBBBBBBBBBBBBBBBBBBBB
